~~~~~~~~
~    ^ ~
~    k ~
~***-**~
~   $   ~
~      ~
~   $   ~
~~~~~~~~