~~~~~~~~
~    ^ ~
~    k ~
~***-**~
~   $  ~
~      ~
~      ~
~~~~~~~~