~~~~~~~~
~    ^ ~
~    k ~
~***-**~
~      ~
~      ~
~  $   ~
~~~~~~~~