~~~~~~~~
~    ^ ~
~    k ~
~~~~~~~~
~    $ ~
~      ~
~   $  ~
~~~~~~~~